If there is anyone out there who still doubts that America is a place where all things are possible, who still wonders if the dream of our founders is alive in our time, who still questions the power of our democracy, tonight is your answer.	아직도 미국이 무한한 가능성의 나라라는 것을 의심하는 사람이 있다면, 아직도 이 나라의 선조들이 꾸었던 꿈들이 살아있는가에 대한 의문을 품은 사람이 있다면, 그리고 민주주의의 힘을 믿지 못하는 사람들이 있다면, 오늘이 그 모든 의문에 관한 답입니다.
It's the answer told by lines that stretched around schools and churches in numbers this nation has never seen, by people who waited three hours and four hours, many for the first time in their lives, because they believed that this time must be different, that their voices could be that difference.	투표소였던 학교와 교회들을 휘감았던 긴 줄들, 역사상 유례 없던 최다 투표율, 세 시간이고 네 시간이고 투표하기 위해 기다렸던 사람들; 바로 지금이 변화의 시기이며 자신의 목소리가 바로 그 변화라는 굳은 믿음 하에 인생 처음으로 투표했던 사람들, 이 모두가 사람들이 품었던 의문들에 대한 답입니다.
It's the answer spoken by young and old, rich and poor, Democrat and Republican, black, white, Hispanic, Asian, Native American, gay, straight, disabled and not disabled.	젊은이, 늙은이, 빈자, 부자, 민주당, 공화당, 흑인, 백인, 라틴계 미국인, 동양인, 아메리카 인디언, 동성애자, 이성애자, 장애를 가진 자들, 장애가 없는 자들 - 우리 모두가 사람들이 품었던 의문들에 답했습니다.
Americans who sent a message to the world that we have never been just a collection of individuals or a collection of red states and blue states.	미국인들은 우리가 개인의 컬렉션이나 적색 주와 청색 주를 수집 한 적이 결코 없다는 메시지를 전세계에 보냈습니다.
It's the answer that led those who've been told for so long by so many to be cynical and fearful and doubtful about what we can achieve to put their hands on the arc of history and bend it once more toward the hope of a better day.	그것은 역사의 테두리에 손을 얹고 자신이 원하는 것을 향해 더 많은 것을 성취하기 위해 달성 할 수있는 것과 더 좋은 날의 희망을 향해 한 번 더 기울여 온 것에 대해 오랫동안 냉소적이고 두려워하고 의심스러워 하는 많은 사람들이 이야기해온 것을 이끄는 대답니다.
It's been a long time coming, but tonight, because of what we did on this date in this election at this defining moment change has come to America.	오랜 시간이 지났지만, 오늘 밤 선거날짜에 우리가 한 일 때문에 결정적인 변화의 순간이 미국으로 왔습니다.
A little bit earlier this evening, I received an extraordinarily gracious call from Sen. McCain.	저는 오늘밤 방금 전 맥케인 의원님에게 굉장히 기품 있는 전화를 받았습니다.
Sen. McCain fought long and hard in this campaign.	그는 이 캠페인에서 오랫동안 열심히 싸웠습니다.
And he's fought even longer and harder for the country that he loves.	그가 사랑하는 이 국가를 위해서는 더욱 오랫동안 열심히 싸워왔습니다.
He has endured sacrifices for America that most of us cannot begin to imagine.	그는 국가를 위해 우리 대부분이 상상도 할 수 없는 희생을 감내해 왔습니다.
We are better off for the service rendered by this brave and selfless leader.	우리는 맥케인 의원님 같은 분들의 용기와 사심 없는 지도력 때문에 훨씬 좋아졌습니다.
I congratulate him.	저는 그를 축하합니다.
I look forward to working with them to renew this nation's promise in the months ahead.	앞으로 몇 달 동안 나라의 약속을 새롭게하기 위해 그들과 함께 일하기를 기대합니다.
I want to thank my partner in this journey, a man who campaigned from his heart, and spoke for the men and women he grew up with on the streets of Scranton and rode with on the train home to Delaware, the vice president-elect of the United States, Joe Biden.	저는 이 긴 여행동안 함께 해 주었던 동료이자, 가슴으로부터 이 캠페인을 이끌며, 그가 자랐단 스크랜턴거리의 모든 분들을 대표해 서슴없이 자신의 주장을 펼쳤고 델러웨어로 집으로 가는 기차를 탄 미합중국의 부통령 조 바이든에게 감사를 표하고 싶습니다.
And I would not be standing here tonight without the unyielding support of my best friend for the last 16 years the rock of our family, the love of my life, the nation's next first lady Michelle Obama.	지난 16년 저의 가장 친한 친구이자 우리 가족의 든든한 기반, 제 인생의 모든 것을 바쳐도 좋을 사랑, 그리고 우리 국가의 퍼스트 레이디, 미셸 오바마가 아니었다면 저는 이 자리에 서지 못했을 것입니다. 그리고 백악관으로 이사 가는 날 강아지를 선물 할 것을 약속한다.
Sasha and Malia I love you both more than you can imagine.	사샤와 말리아 나는 너희들이 상상하는 이상 둘을 사랑한다.
And you have earned the new puppy that's coming with us to the new White House.	그리고 너희들은 새로운 백악관으로 우리와 함께 가는 새로운 강아지를 얻었다.
And while she's no longer with us, I know my grandmother's watching, along with the family that made me who I am.	그리고 그녀는 더 이상 우리와 함께 있지는 않지만 저는 저의 할머니께서 지금의 나를 만들어 준 가족을 지켜보고 있음을 압니다.
I miss them tonight.	저는 오늘밤 그들을 그리워합니다.
I know that my debt to them is beyond measure.	저는 그들에게 진 저의 빚이 헤아릴 수 없다는 것을 알고 있습니다.
To my sister Maya, my sister Alma, all my other brothers and sisters, thank you so much for all the support that you've given me.	내 동생 마야, 누이 앨마, 모든 다른 형제와 자매들에게 저에게 주신 모든 지원에 대해 당신에게 너무 감사드립니다.
I am grateful to them.	저는 그들에게 감사합니다.
And I am forever grateful for what you've sacrificed to get it done.	그리고 저는 당신이 이것을 이루기 위해 희생한 것에 대해 영원히 감사합니다.
But above all, I will never forget who this victory truly belongs to.	하지만 무엇보다 저는 진정으로 이 승리를 가진 사람을 결코 잊지 않을 것입니다.
It belongs to you.	이것은 당신에게 속합니다.
I was never the likeliest candidate for this office.	저는 이 자리를 위한 가장 적합한 후보가 아니었습니다.
We didn't start with much money or many endorsements.	우리는 많은 돈이나 많은 자원금으로 시작하지 않았습니다.
Our campaign was not hatched in the halls of Washington.	우리의 캠페인은 워싱턴의 회의장에서 탄생하지 않았습니다.
It began in the backyards of Des Moines and the living rooms of Concord and the front porches of Charleston.	이 캠페인은 데스 모인즈의 평범한 가정의 뒷마당, 콩코드의 거실, 그리고 찰스턴의 앞뜰에서 탄생했습니다.
It was built by working men and women who dug into what little savings they had to give $5 and $10 and $20 to the cause.	이것은 5불과 10불 그리고 20불씩 조금씩 모아 기부한 열심히 일하는 남자와 여자에 의해 세워졌습니다.
It grew strength from the young people who rejected the myth of their generation's apathy who left their homes and their families for jobs that offered little pay and less sleep.	이것은 적은 월급과 적은 잠을 제공하는 일을 위해 가족과 가정을 떠났고 그들 세대들의 무관심의 믿음을 거부한 젊은이들로 부터 힘을 키웠습니다.
It drew strength from the not-so-young people who braved the bitter cold and scorching heat to knock on doors of perfect strangers.	뼈에 사무치게 추운 날씨도, 타 들어갈 것 같이 더운 날에도 전혀 알지 못하는 사람들의 문을 두드린 그다지 젊지 않은 용감한 사람들로 부터 힘을 키웠습니다.
They proved that more than two centuries later a government of the people, by the people, and for the people has not perished from the Earth.	그들은 링컨 이후 이백 년이나 지났어도 국민의, 국민에 의한, 국민을 위한 정부는 지구에서 라지지 않았음을 입증했습니다.
This is your victory.	이것은 당신들의 승리입니다.
And I know you didn't do this just to win an election.  그리고 저는 여러분이 단지 선거에 이기기 위해 한 것이 아니라는 것을 압니다.
And I know you didn't do it for me.	그리고 저는 여러분이 나를 위해서 한 것이 아니라는 것을 압니다.
You did it because you understand the enormity of the task that lies ahead.	당신들은 앞으로 놓은 과제들이 엄청남을 알고 있기 때문에 이것을 했습니다.
For even as we celebrate tonight, we know the challenges that tomorrow will bring are the greatest of our lifetime.	오늘은 우리의 승리를 축하하지만, 우리는 내일이 가져올 시련이 우리 평생에서 가장 크다는 것을 알고 있습니다.
Even as we stand here tonight, we know there are brave Americans waking up in the deserts of Iraq and the mountains of Afghanistan to risk their lives for us.	오늘 밤 우리는 이 자리에 서 있지만, 지금 이 시각에도 우리 모두의 안전을 위해 아프가니스탄의 산와 이라크의 사막에서 깨어나 목숨을 걸고 싸우고 있는 용감한 미국인들이 있다는 것을 잊어서는 안됩니다.
There are mothers and fathers who will lie awake after the children fall asleep and wonder how they'll make the mortgage or pay their doctors' bills or save enough for their child's college education.	어떻게 그들의 아이들 대학교육을 위한 충분한 저축하거나 그들의 의사의 청구서를 지불하거나 담보 대출을 갚아야할지 고민하고 아이들이 잠든 후에 뜬눈으로 밤을 지새는 아버지와 어머니들이 있다는 것을 잊어서는 안됩니다.
There's new energy to harness, new jobs to be created, new schools to build, and threats to meet, alliances to repair.	새로운 에너지, 새로운 일자리 창출, 새로운 학교 건설, 그리고 만나야 할 위협, 수리해야 할 동맹이 있습니다.
The road ahead will be long.	우리 앞에 놓인 길은 길어요.
Our climb will be steep.	우리는 가파른 길을 올라가야 해요.
We may not get there in on-e year or even in on-e term.	우리는 일 년이나 일 년 안에 그곳에 도착하지 못할 수도 있습니다.
But, America, I have never been more hopeful than I am tonight that we will get there.	하지만, 미국이여, 저는 우리가 해낼 것이라고 오늘 밤보다 더 희망적으로 본 적이 없었어요.
I promise you, we as a people will get there.	장담하건대, 우리는 국민으로서 성공할 것입니다.
There will be setbacks and false starts.	좌절과 잘못된 시작이 있을 것입니다.
There are many who won't agree with every decision or policy I make as president.	제가 대통령으로서 내리는 모든 결정이나 정책에 동의하지 않는 사람들이 많습니다.
And we know the government can't solve every problem.	그리고 우리는 정부가 모든 문제를 해결할 수 없다는 것을 알고 있습니다.
But I will always be honest with you about the challenges we face.	하지만 저는 우리가 직면한 문제들에 대해 여러분에게 항상 솔직하게 말할 것입니다.
I will listen to you, especially when we disagree.	특히 우리가 동의하지 않을 때, 나는 당신의 말을 듣겠습니다.
And, above all, I will ask you to join in the work of remaking this nation, the on-ly way it's been done in America for 221 years.	그리고 무엇보다도, 저는 여러분에게 이 나라를 다시 만드는 일에 동참해 달라고 부탁할 것입니다 미국에서 221년 동안 진행되어 온 바로 그 방법입니다.
What began 21 months ago in the depths of winter cannot end on this autumn night.	한겨울에 21개월 전 시작된 일이 이 가을밤에도 끝날 수가 없군요.
This victory alone is not the change we seek.	이 승리만으로는 우리가 추구하는 변화가 아닙니다.
It is on-ly the chance for us to make that change.	그것은 우리가 그 변화를 만들 수 있는 기회입니다.
And that cannot happen if we go back to the way things were.	우리가 과거로 돌아간다면 그런 일은 일어나지 않을 거예요.
It can't happen without you, without a new spirit of service, a new spirit of sacrifice.	그것은 당신 없이는, 새로운 봉사의 정신이나 희생의 정신 없이는 일어날 수 없습니다.
So let us summon a new spirit of patriotism, of responsibility, where each of us resolves to pitch in and work harder and look after not on-ly ourselves but each other.	자 그럼 이제 새로운 애국심과 책임감을 불러봅시다. 우리 각자가 참여해서 더 열심히 일하고 우리 자신이 아니라 서로를 돌보기로 마음먹죠.
Let us remember that, if this financial crisis taught us anything, it's that we cannot have a thriving Wall Street while Main Street suffers.	이 금융위기가 우리에게 뭔가를 가르쳐 준다면, 메인 스트리트가 고통받고 있는 동안 월 스트리트를 번창시킬 수 없다는 것을 기억하세요.
In this country, we rise or fall as one nation, as one people.	이 나라에서, 우리는 하나의 국가로서, 하나의 민족으로서, 떨어지거나 오릅니다.
Let's resist the temptation to fall back on the same partisanship and pettiness and immaturity that has poisoned our politics for so long.	우리 정치를 오랫동안 오염시킨 당파심, 미숙함, 미숙함에 의지하고 싶은 유혹을 이겨내자구요.
Let's remember that it was a man from this state who first carried the banner of the Republican Party to the White House, a party founded on the values of self-reliance and individual liberty and national unity.	공화당의 깃발을 처음으로 백악관으로 옮긴 사람은 바로 이 주에서 온 사람이라는 것을 기억하세요. 백악관은 자기 의존과 개인의 자유와 국가 통합의 가치를 바탕으로 만들어진 정당입니다.
Those are values that we all share.	그것은 우리 모두가 공유하는 가치입니다.
And while the Democratic Party has won a great victory tonight, we do so with a measure of humility and determination to heal the divides that have held back our progress.	그리고 민주당이 오늘 밤 큰 승리를 거두긴 했지만, 우리는 겸손과 우리의 발전을 저해했던 분열을 치유할 결의로 그렇게 합니다.
As Lincoln said to a nation far more divided than ours, we are not enemies but friends.	링컨이 우리보다 훨씬 더 분단된 나라에 말했듯이, 우리는 적이 아니라 친구입니다.
Though passion may have strained, it must not break our bonds of affection.	열정이 불편했을 수도 있지만, 그것이 우리의 애정의 끈을 깨뜨려서는 안 됩니다.
And to those Americans whose support I have yet to earn, I may not have won your vote tonight, but I hear your voices.	그리고 제가 아직 지지를 받지 못한 미국인들에게, 오늘 밤 당신의 표를 얻지 못했을 수도 있지만, 저는 당신의 목소리를 들었습니다.
I need your help And I will be your president, too.	신의 도움이 필요해요 그리고 저도 여러분의 대통령이 될 것입니다.
And to all those watching tonight from beyond our shores, from parliaments and palaces, to those who are huddled around radios in the forgotten corners of the world, our stories are singular, but our destiny is shared, and a new dawn of American leadership is at hand.	그리고 오늘 밤 우리의 해변 밖에서, 의회와 궁궐에서, 그리고 잊혀진 세계의 구석의 라디오 주변에 모여있는 사람들에게, 우리의 이야기는 독특하지만, 우리의 운명은 공유되고, 미국의 지도력의 새로운 동명이 다가왔습니다.
We will defeat you.	우리는 당신을 이길 것입니다.
We support you.	응원합니다.
Tonight we proved once more that the true strength of our nation comes not from the might of our arms or the scale of our wealth.	오늘 밤 우리는 다시 한번 우리 나라의 진정한 힘은 우리 팔의 힘이나 부의 규모에서 오는 것이 아니라는 것을 증명했습니다.
That's the true genius of America.	그것은 미국의 진정한 천재입니다.
America can change.	미국은 변할 수 있습니다.
Our union can be perfected.	우리 조합은 완벽할 수 있습니다.
What we've already achieved gives us hope for what we can and must achieve tomorrow.	우리가 이미 성취한 것은 우리가 내일 성취할 수 있고 반드시 달성해야 하는 것에 대한 희망을 줍니다.
This election had many firsts and many stories that will be told for generations.	이번 선거는 여러 세대에 걸쳐 전해질 많은 처음과 이야기들이 있었습니다.
But one that's on my mind tonight's about a woman who cast her ballot in Atlanta.	하지만 오늘 밤 저는 애틀랜타에서 투표한 한 여성에 대해 생각하고 있습니다.She's a lot like the millions of others who stood in line to make their voice heard in this election except for one thing.	그녀는 이번 선거에서 한 가지를 제외하고는 자신들의 목소리를 내기 위해 줄을 서 있던 수백만의 다른 사람들과 매우 흡사합니다.
Ann Nixon Cooper is 106 years old.	앤 닉슨 쿠퍼는 106세입니다.
She was born just a generation past slavery.	그녀는 노예제도를 지나 한 세대 전에 태어났습니다.
And tonight, I think about all that she's seen throughout her century in America.	그리고 오늘 밤, 저는 그녀가 미국에서 세기를 통틀어 본 모든 것에 대해 생각합니다.
We were told that we can't, and the people who pressed on with that American creed.	우리는 그럴 수 없다는 말을 들었습니다 그리고 그 미국식 신조를 고집한 사람들은요.Yes we can.	네, 할 수 있어요.
At a time when women's voices were silenced and their hopes dismissed, she lived to see them stand up and speak out and reach for the ballot.	여성의 목소리가 잠잠해지고 그들의 희망은 사라졌을 때, 그녀는 그들이 일어서서 투표용지에 손을 뻗는 것을 보기 위해 살았습니다.
Yes we can.	네, 할 수 있어요.
When there was despair in the dust bowl and depression across the land, she saw a nation conquer fear itself with a New Deal, new jobs, a new sense of common purpose.	쓰레기통에서 절망과 전국에 걸친 불황이 있을 때, 그녀는 국가가 뉴딜정책, 새로운 일자리, 새로운 공동의 목적을 가지고 두려움을 극복하는 것을 보았습니다.
Yes we can.	네, 할 수 있어요.
When the bombs fell on our harbor and tyranny threatened the world, she was there to witness a generation rise to greatness and a democracy was saved.	우리 항구에 폭탄이 떨어졌고 폭정이 세계를 위협했을 때, 그녀는 한 세대의 위대함을 목격하고 민주주의를 구했습니다.
Yes we can.	네, 할 수 있어요.
She was there for the buses in Montgomery, the hoses in Birmingham, a bridge in Selma, and a preacher from Atlanta who told a people that "We Shall Overcome."	그녀는 몽고메리에 있는 버스들, 버밍엄의 호스들, 셀마의 다리, 애틀랜타에서 온 설교자 한 명이 "우리는 극복해야 한다"고 말했습니다.
Yes we can.	네, 할 수 있어요.
A man touched down on the moon, a wall came down in Berlin, a world was connected by our own science and imagination.	한 남자가 달에 착륙했고, 베를린에 벽이 내려왔습니다. 세상은 우리 자신의 과학과 상상에 의해 연결되어 있었습니다.
And this year, in this election, she touched her finger to a screen, and cast her vote, because after 106 years in America, through the best of times and the darkest of hours, she knows how America can change.	그리고 올해, 이번 선거에서, 그녀는 화면에 손가락을 갖다 대고 투표를 했습니다. 왜냐하면 미국에서 106년 동안 가장 좋은 시간과 가장 어두운 시간을 거쳐서, 그녀는 미국이 어떻게 변화할 수 있는지 알고 있기 때문입니다.
Yes we can.	네, 할 수 있어요.
America, we have come so far.	미국, 우리는 여기까지 왔어요.
We have seen so much.	정말 많이 봤어요.
But there is so much more to do So tonight, let us ask ourselves.	하지만 할 일이 너무 많아요 그래서 오늘 밤, 우리 자신에게 물어봐요.
This is our chance to answer that call.	지금이 그 전화를 받을 수 있는 기회입니다.
This is our moment.	지금이 우리의 순간입니다.
Thank you.	감사해요.
God bless you.	신의 가호가 있기를.
And may God bless the United States of America.	그리고 하느님이 미국을 축복하시길 바랍니다.